111111111111
100010100001
100010101101
101110101101
100000100001
111110111101
101010000101
101010110101
100000110101
101110000101
100010110101
101010100001
111111111111